*****
*.#.*
*...*
*...*
*.X.*
*****
