******************************
*..*................*.....*..*
*..*.....*****.*.......*.....*
*.**.....*.*.*.*.***********.*
*......***.*...........*.....*
******.*...*.*.*************.*
*......*.....*#*.............*
*.**************.*************
*.............*.......*.....**
*..**....*....*....*......*..*
*...*.*******.*.**************
**..*.........*.*...*........*
*...*.*********...*.*****..*.*
*..**.........*.*.*........*.*
*...*...*****.****************
*********....................*
*...*...*..******.************
*.*...*.....*...*............*
*.***********.X.************.*
*......*..*..................*
*.******....*..*************.*
*......*..*.*..............*.*
*****..*..*.*..*..************
*...*.**..*.****.......*.....*
***.*.....*.*......*...*****.*
*.*.*****.***.******...*.....*
*.*.....*.....*....*......**.*
*.****..*******..*.********..*
*................*...........*
******************************
