****************************************
*......................................*
*......................................*
*......................................*
*......................................*
*......................................*
*..................#...................*
*......................................*
*......................................*
*......................................*
*......................................*
*......................................*
*......................................*
*......................................*
*......................................*
*..................X...................*
*......................................*
*......................................*
*......................................*
****************************************
