***************
*.............*
***..*****....*
*.*......*....*
*.********....*
*.............*
*.............*
*..****...*****
*.....*.......*
*.....****....*
*........*....*
****.....*....*
*..*..#..*....*
*..*******....*
*............X*
***************
