*****************************************
*.......................................*
*.......................................*
*..................*....................*
*.......................................*
*.......................................*
*..................*....................*
*.......................................*
*.......................................*
*..................*....................*
*.......................................*
*.......................................*
*.......................................*
*.......................................*
*..................X....................*
*.......................................*
*.......................................*
*.......................................*
*.......................................*
*****************************************
