********************
*..................*
*.****.............*
*.*..*.............*
*.*..*.............*
*.*.**.............*
*..................*
*..................*
*.X................*
*..................*
*..................*
*..................*
*..................*
*..................*
*..................*
*..................*
*..................*
*..................*
*..................*
********************
