*****
*...*
*.X.*
*...*
*****
